########################
###    #################
###    #################
###    #################
###    #################
### ###         ########
### ###    #    ########
### ###         ########
### ###         ########
###      #   #  ########
#######         ########
#######         ########
#######    #    ########
#######         ########
######### ##############
######### ##############
######### ##############
######### ##############
#   ##### ##############
#                      #
#   ###########        #
###############        #
###############        #
########################